  XXXXXX XX XXXXX
X     XXXXX XXXXX
X XXX XXX X    XX
X X   XXXXXXXX XX
XXX XXXXX XXXXXXX
XXX       XXX   X
XXX XXXXX XXX XXX
XXX   XXX     XXX
XXXXX XXXXXXX   D